+--+--+--+--+--+--+--+
|        |           |
+  +--+  +  +--+  +--+
|     |  |  |  |     |
+--+  +  +  +  +--+  +
|  |  |  |        |  |
+  +  +  +--+--+  +  +
|     |        |  |  |
+  +--+--+--+  +  +  +
|  |     |     |  |  |
+  +--+  +--+--+--+  +
|     |     |     |  |
+--+  +  +  +  +  +  +
|        |     |    g|
+--+--+--+--+--+--+--+