+--+--+--+--+--+--+--+
|p       |           |
+  +--+  +  +--+  +--+
|     |  |  |  |     |
+--+  +  +  +  +--+  +
|  |  |  |        |  |
+  +  +  +--+--+  +  +
|     |        |  |  |
+  +--+--+--+  +  +  +
|  |     |     |  |  |
+  +--+  +--+--+--+  +
|     |     |     | g|
+--+  +  +  +  +  +  +
|        |     |     |
+--+--+--+--+--+--+--+